######################
#     #    #         #
# @   #  $ # .       #
#     #    #         #
#  P  #### #         #
#   B     ##   ####  #
#  T S$    #   #     #
#   R K    # . #     #
#    F  #  #   ####  #
#    #  #  #     #   #
#  $ #  #  #  $  #   #
#    #  #  #  .  #   #
# .  #     #     #   #
#    #     #         #
#  $ #     #     .   #
######################