##########
#        #
# @   $  #
#    #   #
#  P   . #
#   #    #
#  TS    #
#   R K  #
#    F   #
##########